SSSBBBCCC
CCCCBCBCC
CCCCCCBCC
CCCCCCBCB
CCCCCCBCC
BCBCBCBCC
CCCCCCCCC
CCCCCCCCC
CCBCCCCCB
